244 16
------------------------------------------------a-----------------------------------------------------------------------------------------------------------------------n------------------------------------n-------------d-----------------------
-----------------------------------------------------------------------------------------------------------------------------------------a------------------------------n------------------------------------n----------------------------P--------
------------------------------------------------------------------------------------------------------------------------------------------------------------------------n------------------------------------n---+-----------------+---------------
-------------------------------------------------------------------------------------------------------------------------------------+--------------+-------------------n------------------------------------n--------------------nnnn-------------
------------------------------------------------------------------------------------------------------------------------------------l*r------------l*r------------------n--+---------------------------------n---------t-E---t---nnnnnn-----------t
--------S---------------------------------------------------------------------------------------------------------------------------------------------------------------n-l*r----------n-----------l*r--------------l************************r----t
---------d--------+s--------------------------7=========8-----7=========4-------c---E-------------------b-----------------------E----------------------E------h---------n---------l*r--n---l***rg--------------o-------------p-------------------tt
-i---------------l*r------------------------7=6#########2---*-1##2---1##2-----------l**r--------------------------------------l****************************r------------n--------------n---------------------------------------------------------tt
------l****r------------------------------7=6#~~~~~~~~~~2-----1~~2-+-1~~2----------------------------------------------l*r----------------------------------------------n--------------n-------------------nnnnn--------------------------------ttt
----------------------------------------7=6##2-------------------------------l*r-----------l*r--------------------------------------------------------------------------n----l*r-------n--------------------nnn------E--------------------------ttt
-nnn----------------------------------7=6####2----------------------------------------------------------------------*---------------------------------------------------n-------------nn-----------------*---n-------l**r---------------------3====
-nnn--------------------------------7=6######2--+-----------------E-------------------------------E----------------------------------------------------------------------------------nnn---------------------n----------------------------+---1####
-nnn------------------------------7=6########2------7=====================4-----------------------l**r----------l*r---------------------------------------------------------------nnnnnn-------------------+-n----------------------------*---1####
-nnn-----------E---------------3=56##########2----7=6#####################2------------------------------------------------------------------+------------------------------------nnnnnn--E------------------n--------------------------------1####
==========================4----1#############9===56#######################2--3==========================================4---3=======4--*--*--*--*--*--3================================================================================4------1####
##########################2^^^^1##########################################2^^1##########################################2^^^1#######2^^^^^^^^^^^^^^^^^1################################################################################2^^^^^^1####
