133 35
------------------------------------------------------------------------------------------------------------------------------------
------------------------------------------------------------------------------------------------------------------------------------
------------------------------------------------------------------------------------------------------------------------------------
-------------------------------------------------------------------------------------------------------------------------------------
------------------------------------------------------------------------------------------------------------------------------------
------------------------------------------------------------------------------------------------------------------------------------
------------------------------------------------------------------------------------------------------------------------------------
------------------------------------------------------------------------------------------------------------------------------------
------------------------------------------------------------------------------------------------------------------------------------
-------------------------------------------------------------------------------------------------------------------------------------
------------------------------------------------------------------------------------------------------------------------------------
------------------------------------------------------------------------------------------------------------------------------------
------------------------------------------------------------------------------------------------------------------------------------
------------------------------------------------------------------------------------------------------------------------------------
-+----------------------------------------------------------------------------------------------------------------------------------
-+-------------------------------------------------------------------------------------------------------------------------------------
===============2--------------------------------------------------------------------------------------------------------------------
------------------------------------------------------------------------------------------------------------------------------------
---------------------1=2------------------------------------------------------------------------------------------------------------
-----------------------------------------------------------------------------------------------------=======-------------------------
-----------------------------------------------------------------------------------------------------=======-------------------------
---------------------------------------------------------------------------------------------------==-------------------------------
---------------1=2------------------------------------------------------------------------------------------------------------------
---------------------------------------------------------------------------------------------========---------------------------------
---------------------------------------------E-----------------E------------E-------------------------------------------------------
----------------------------------------R===========LMM------R===LMM------R===L-------------------------------------------------------
---------------------12-----------------r###########l--------r###l--------r###l==============----------------------------------------
----------------------------------------r###########l--------r###l--------r###l-----------------------------------------------------
--S--------------------------------R====3###########l--------r###l--------r###l-----------------------------------------------------
-----------------------------------r################l--------r###l--------r###l-----------------------------------------------------
-----------MMM-------------E-------r################4^^^^^^^^3###4^^^^^^^^3###4-----------------------------------------------------
==========L-------------R==========3#############################################################--------------------------------------
##########lWWWWWWWWWWWWWr########################################################################-----------------------------------
##########lWWWWWWWWWWWWWr########################################################################-----------------------------------
