53 14
----------------------------------------------------
----------------------------------------------------
----------------------------------------------------
----------------------------------------------------
----------------------------------------------------
----------------------------------------------------
----------------------------------------------------
----------------------------------------------------
----------------------------------------S----P------
------------------------N---------------------------
----------------------------------------------------
----------------------------------------------------
----------------------------------------------------
====================================================
