245 34
----------------------------------------------------------------------------------------------------------------------------------------------------------------------------------------------------------------------------------------------------
----------------------------------------------------------------------------------------------------------------------------------------------------------------------------------------------------------------------------------------------------
-----------------------------------------------------------------------------------------------------------------------------rl---------------------------------------------------------------------------------------------------------------------
-----------------------------------------------------------------------------------------------------------------------------rl---------------------------------------------------------------------------------------------------------------------
-----------------------------------------------------------------------------------------------------------------------------rl---------------------------------------------------------------------------------------------------------------------
-----------------------------------------------------------------------------------------------------------------------------rl---------------------------------------------------------------------------------------------------------------------
-----------------------------------------------------------------------------------------------------------------------------rl---------------------------------------------------------------------------------------------------------------------
-----------------------------------------------------------------------------------------------------------------------------rl---------------------------------------------------------------------------------------------------------------------
-----------------------------------------------------------------------------------------------------------------------------rl---------------------------------------------------------------------------------------------------------------------
-----------------------------------------------------------------------------------------------------------------------------rl---------------------------------------------------------------------------------------------------------------------
-----------------------------------------------------------------------------------------------------------------------------rl---------------------------------------------------------------------------------------------------------------------
-----------------------------------------------------------------------------------------------------------------------------rl---------------------------------------------------------------------------------------------------------------------
-----------------------------------------------------------------------------------------------------------------------------rl---------------------------------------------------------------------------------------------------------------------
-----------------------------------------------------------------------------------------------------------------------------rl---------------------------------------------------------------------------------------------------------------------
-----------------------------------------------------------------------------------------------------------------------------rl-----------------------------------------------------------------------------------------------------------------P---
-+---------------------------------------------------------------------------------------------------------------------------rl---------------------------------------------------------------------------------------------------------------------
===============2-------------------------------------------------------------------------------------------------------------rl---------------------------------------------------------------------------------------------------------------------
----------------------------------------------------------------------------------------------------------------==------RL---rl---------------------------------------------------------------------------------------------------------------------
---------------------1=2------------------------------------------------------------------------------------------------rl---rl-----------------------------------------------------------------------------------------------------------R=========
------------------------------------------------------------------------------------------------------------------------rl---rl---------------------------------------------------------------------------------------------------------R=3#########
------------------------------------------------------------------------------------------------------------------------rl---rl------------------------------------------------------==-----------------------------------------------R=3###########
----------------+-----------------------------------------------------------------------R======L------------------------rl---rl-----------MMM---------------------------------------------------------------------------------------R=3#############
---------------1=2-----------------------------------------------------------------R====3######l----------------------==rl---rl+--------------------------------------------------------------------------------------------------R=3###############
-----------------------------------------------------------------------------------rDDDDDDDDDDDl------------------------rl---rl==-----------------------------------==----------------------------------------------------------R=3#################
--------------------------------------------E-----------------E------------E------------------------E------------------rl-+-rl------------------------------------------------==------------------E--------------------------R=3####################
----------------------------------------R===========LMM------R===LMM------R===L--------------------R===L----------------rl---rl-------------------------R=L--------------------------------------======---------------------R=3#####################
---------------------12-----------------r###########l--------r###l--------r###l--------------------r###4==L-----==------rl---rl-------------------------r#l---------------------------------------------------------------R=3#######################
--S-------------------------------------r###########l--------r###l--------r###l--------------------rDDDDDDl-------------rl------------------------------r#l-------------=-----------------------------------------------R=3#########################
-----------------------------------R====3###########l--------r###l--------r###l-----------------------------------------rl-----------------------R=L----r#l-----------------------------------------------------------R=3###########################
-----------------------------------r################l--------r###l--------r###l-----------------------------------------rl-----------------------r#l----r#l---------------------------------------------------------R=3#############################
-----------MMM-------------E-------r################4^^^^^^^^3###4^^^^^^^^3###4^^^^^^^^^^^^^^^^^^^^^^^^^^^^^^^^^^^^^^^^^rl-----------------------r#l----r#l-----E-----E--------------------------------------E----R=3###############################
==========L-------------R==========3####################################################################################rl=============L---------r#l----r#4===================L-------------R=====================3#################################
##########lWWWWWWWWWWWWWr##############################################################################################################lWWWWWWWWWr#l^^^^r#####################lWWWWWWWWWWWWWr#######################################################
##########lWWWWWWWWWWWWWr###########################################################################################################################################################################################################################
