67 72
---------------------#--------------------------------------------
---------------------#--------------------------------------------
---------------------#--------------------------------------------
---------------------#--------------------------------------------
---------------------#--------------------------------------------
---------------------#--------------------------------------------
---------------------#--------------------------------------------
---------------------#--------------------------------------------
---------------------#--------------------------------------------
---------------------#--------------------------------------------
---------------------#--------------------------------------------
---------------------#--------------------------------------------
---------------------#--------------------------------------------
---------------------#--------------------------------------------
---------------------#--------------------------------------------
---------------------#--------------------------------------------
---------------------#--------------------------------------------
---------------------#--------------------------------------------
---------------------#--------------------------------------------
---------------------#--------------------------------------------
---------------------#--------------------------------------------
---------------------#--------------------------------------------
---------------------#--------------------------------------------
---------------------#--------------------------------------------
---------------------#--------------------------------------------
---------------------#--------------------------------------------
---------------------#--------------------------------------------
---------------------#--------------------------------------------
---------------------#--------------------------------------------
---------------------#--------------------------------------------
---------------------#--------------------------------------------
---------------------#--------------------------------------------
---------------------#--------------------------------------------
---------------------#--------------------------------------------
---------------------#--------------------------------------------
---------------------#--------------------------------------------
---------------------#--------------------------------------------
---------------------#--------------------------------------------
---------------------#--------------------------------------------
---------------------#--------------------------------------------
---------------------#--------------------------------------------
---------------------#--------------------------------------------
---------------------#--------------------------------------------
---------------------#--------------------------------------------
---------------------#--------------------------------------------
---------------------#--------------------------------------------
---------------------#--------------------------------------------
---------------------#--------------------------------------------
---------------------#--------------------------------------------
---------------------#--------------------------------------------
---------------------#--------------------------%%%---------------
---------------------#-----------------------------%%%%%%%--------
---------------------#--------------------------------------------
---------------------#--------------------------------------------
---------------------#---------------------------------------%%%--
---------------------#--------------------------------------------
---------------------#--------------------------------------------
---------------------#------------------------------%%%%%%%%------
---------------------#--------------------------%%%%--------------
---------------------#------------------------%%------------------
---------------------#-------------------------------------%%%%%--
---------------------#--------------------------------------------
---------------------#------------------%%%%----------------------
---------------------#--------------------------------------------
---------------------#--------------------------------------------
----------------------------------------------%%%-----------------
--#-------------------------------S-------------------------------
------------------------------------------------------------------
------------------------------------------%%%%--------------------
==================================================================
##################################################################
##################################################################
