67 33
------------------------------------------------------------------
------------------------------------------------------------------
------------------------------------------------------------------
-------------------------------------------------------------------
------------------------------------------------------------------
------------------------------------------------------------------
------------------------------------------------------------------
------------------------------------------------------------------
------------------------------------------------------------------
-------------------------------------------------------------------
------------------------------------------------------------------
------------------------------------------------------------------
------------------------------------------------------------------
------------------------------------------------------------------
-+----------------------------------------------------------------
-+-----------------------------------------------==------------------
===============2-------------------------------------E-E----------
-----------------------------------------------------------------
---------------------1=2-----------------------------------------
-----------------------------------------------------------------
------------------------------------------------------------------
-------------------------------------------------------------------
---------------1=2------------------------------------------------
------------------------------------------------------------------
-----------------------------------------------------------------
---------------------12--------------------------------------------
------------------------------------------------------------------
--S---------------------------------------------------------------
------------------------------------------------------------------
-----------MMM-------------E---------------------------------------
==========L-------------R=========================================
##########lWWWWWWWWWWWWWr#########################################
##########lWWWWWWWWWWWWWr#########################################
