244 16
------------------------------------------------------------------------------------------------------------------------------------------------------------------------1----------------------------------- 1-----------1###############2---------
------------------------------------------------------------------------------------------------------------------------------------------------------------------------1------------------------------------1-----------1###############2---------
------------------------------------------------------------------------------------------------------------------------------------------------------------------------1------------------------------------1---+-------------------------P-------
---S---------------------------------------------------------------------------------------------------------------------------------+--------------+-------------------1------------------------------------1-------------------------------------
------------------------------------------------------------------------------------------------------------------------------------l*r------------l*r------------------1--+-----------2---------------------1-------------------------------------
------------------------------------------------------------------------------------------------------------------------------------------------------------------------1-l*r-----l*r--2----------------------------------E-----E------------------
--------------------+-------------------------7=========8-----7=========4-----------E----------------------------------------------------E-----E----------E-------------1--------------2---l***r--------------------l************************r-----
---l**r------------l*r----------------------7=6#########2---*-1##2---1##2-----------l*r-----------------------------*--------l********************************r---------1--------------2----------*--*---------------------------------------------
-----------l**r---------------------------7=6#~~~~~~~~~~2-----1~~2-+-1~~2--------------------------------------l*r-----l*r----------------------------------------------1--------------2-------------------l***r-----------------------------------
----------------------------------------7=6##2-------------------------------l*r-----------l*r--------------------------------------------------------------------------1----l*r-------2---------------------1--------------------E----------------
--------------------------------------7=6####2-----------------------------------------------------------l*r------------------------------------------------------------1--------------2-----------------*---1-------------------l**r---------3====
------------------------------------7=6######2--+-----------------E-------------------------------E------------------------------------------------------------------------------------2---------------------1--l*r------E----------------+---1####
----------------------------------7=6########2------7=====================4-----------------------l**r----------------------------------------------------------------------------l*r--2---+-----------------1----------l**r--------------*---1####
-------E----E------------------3=56##########2----7=6#####################2------------------------------------------------------------------+-----------------------------------------2-------E-----E-------1----E---------------+-----------1####
==========================4----1#############9===56#######################2--3==========================================4---3=======4--*--*--*--*--*--3================================================================================4------1####
##########################2----1##########################################2--1##########################################2---1#######2-----------------1################################################################################2------1####
