245 16
----------------------------------------------------------------------------------------------------------------------------------------------------------------------------------------------------------------------------------------------------
----------------------------------------------------------------------------------------------------------------------------------------------------------------------------------------------------------------------------------------------------
---------------------------------d------------------------------------------------------------------------------------------------------------------------------------------------------------------------------------------------------------------
----------------------------------------------------------------------------------------------------------------------------------------------------------------------------------------------------------------------------------------------------
----------------------------------------------------------------------------------------E-----------------------------------------------------------------------------------------------------------------------------------------------------------
------------------------------------------------------------------------------------|=======----------------------------------------------------------------------+-----------------E---------------------------------------------------------------
--------d-------------------E-----------------------------------------------------|=########---------------------------------------------------------------------===---------------====-------------------------------------------------------------
----------------------------=====-----------------------------------------------|=##########---------------------------------------------------------------------------------------------------===--------------------------------------------------
--------------------------------#---------------------------------------------|=############---====---------------------------------=-------------E-------===-----------------==------------------------===-------d-----------==---------------|==*-
--------------------=====-------#-------------------------------------------|=##############-----------------------------------------------------|===-------------------------------------|=------------------------------------------------------x-
-------------=====------#-------#--------------=====----------------------|=############----------------====--------------------=-------------===####------------------====---------------#-----=-------------------------------------=--------P--x-
-S----------------------#-------#---------------------------------------|=##############--------------------------------------------------------------------------------------------------#-----#------------------------==------+----------------x-
------------------------#-------#-------------------------------------|=################-+----------------------------------=-------------------------------------------------------------#-----#--------------------------------=----------------x-
------------------------#^^^^^^^#-------------------------E---------|=##################---------------------E-----------------------------------------------------E----------------------#^^^^^#-------E------------=----------------------------x-
====================================================================####################===================================--------------========================================-----====#=====#==================-----------------------========?=
###########################################################################################################################^^^^^^^^^^^^^^########################################^^^^^#############################^^^^^^^^^^^^^^^^^^^^^^^##########
