245 16
-----------------------------------------------------------------------------------------------------------------#----------------------------------------------#------------------------------------------#----------------------------------------
-----------------------------------------------------------------------------------------------------------------#----------------------------------------------#------------------------------------------#----------------------------------------
--------------------------------d--------------------------------------------------------------------------------#----------------------------------------------#------------------------------------------#----------------------------------------
-----------------------------------------------------------------------------------------------------------------#----------------------------------------------#------------------------------------------#----------------------------------------
-----------------------------------------------------------------------------------------------------------------#----------------------------------------------#------------------------------------------#----------------------------------------
----------------------------------------------------------------------------------------E------------------------#----------------------------------------------#-+-----------------E----------------------#----------------------------------------
--------d-------------------E------------------------------------------------------=========--------------------+#----E-----------------------------------------#===---------------====--------------------#----------------------------------------
----------------------------=====------------------------------------------------|=#########-------------------==#=======--------===----------------------------#------------------------------===------E--#----------------------------------------
--------------------------------#------------------------------------------------###########---====--------------#--------------=-------------------------===---#-------------==------------------------===#------d-----------==---------------|==*-
--------------------=====-------#----------------------------------------E--|==--###########---------------------#--------------------------------E-------------#-------------------------|=------------------------------------------------------x-
-------------====-------#-------#--------------=====----------------------|=###--#######----------------====-----#------------=---------------|======------------------====---------------#-----=-------------------------------------=--------P--x-
-S----------------------#-------#--------------###----------------------|=#####--#######---------------------------------------------------------##---------------------------------------#-----#------------------------==------+----------------x-
------------------------#-------#------------|####-----------=--------|=#######--#######-+----------------------------------=--------------------##---------------------------------------#-----#--------------------------------=----------------x-
------------------------#^^^^^^^#------------#####--------E--#--E---|=#########^^#######---------------------E--------E--------------------------##^^^^^^^^^^------E----------------------#^^^^^#-------E------------=----------------------------x-
====================================================================####################===================================--------------========================================-----====#=====#==================-----------------------========?=
###########################################################################################################################^^^^^^^^^^^^^^########################################^^^^^#############################^^^^^^^^^^^^^^^^^^^^^^^##########
