53 14
----------------------------------------------------
----------------------------------------------------
----------------------------------------------------
----------------------------------------------------
----------------------------------------------------
----------------------------------------------------
----------------------------------------------------
----------------------------------------------------
---------------------------------------------P------
-S----------------------N---------------------------
----------------------------------------------------
----------------------------------------------------
----------------------------------------------------
====================================================
