53 14
----------------------------------------------------
----------------------------------------------------
----------------------------------------------------
----------------------------------------------------
--------------------d-------------------------------
----------------------------------------------------
----------------------------------------------------
----------------------------------------------------
--S------------------------------------------P------
------------------------N---------------------------
----------------------------------------------------
----------------------------------------------------
----------------------------------------------------
====================================================
