222 16
-----------------------------------------------------------------------------------------------------------------------------------------------------------------------------------------------------------------------------
-----------------------------------------------------------------------------------------------------------------------------------------------------------------------------------------------------------------------------
-----------------------------------------------------------------------------------------------------------------------------------------------------------------------------------------------------------------------------
-----------------------------------------------------------------------------------------------------------------------------------------------------------------------------------------------------------------------------
-----------------------------------------------------------------------------------------E------------------------------------------------------------------------------+----------------------------------------------------
-----------------------------------E------------------------------------------------|=======---------------------------------------------------------------------------===---------------------------------------------------
---------------------------------=====--------------------------------------------|=########---------------------------------------------------------------------------------------------------------------------------------
--------------------------------------------------------------------------------|=##########------------------------------------------------------------------===------------------------------------------------------------
-----------------------=====------------------------P-------------------------|=############---====---------------------------------=-------------E---------------------------------------=----=====------------------|====|-
----------------------------------------------------------------------------|=##############-----------------------------------------------------====-------------------------------------#---------------------------=----=-
-------------=====-----------------------------=====----------------------|=############----------------====--------------------=--------------==####------------------====------=====----#---------------------------=----=-
-S----------------------------------------------------------------------|=##############-+------------------------------------------------------------------------------------------------#---------------------------=----=-
----------------------------------------------------------------------|=################------------------------------------=-------------------------------------------------------------#---------------------------=----=-
----------------------------------------------------------E---------|=##################====-----------------E----------------------------------------------------------------------------#----E----------------------=----=-
====================================================================########################===============================------------===================================================#==================================
###########################################################################################################################------------######################################################################################
