191 13
----------------------------------------------------------------------------------------------------------------------------------------------------------------------------------------------
-----###################################################################################E################################################-----------------------##########################---#
-----------------------------------------------------##--######--####------####----------------------------------------------------------------------------------------#########-------------#
-----------------------------------------------------##--######--####------####----------------------------------------------------------------------------------------#########-------------#
---------------------------------------------------##--------##---#----##----------------------------------------------------------------------------------------------#########-------------#
---------------------------------------------------##--------##---#----#-----------------------------------------------------------------------------------------------#########-------------#
--------------------------------------#-####-#-----##--------##---#----#-----------######------------------------------------------------------------------------------#########-------------#
--------------------------------------#-#--#-#-----##--------##---#-#--##----------######-------------------------------------------------------######-----------------#########-------------#
---------=====--------=-=-------------###--###-----####--######---###--##--####--------------------------------------------------------==------------------------------#########-------------#
--------------------=-=-=-=---=----------------------##------------------------------------------------------------------##-----------===----------------------#################-##--##--##--#
------------------=-=-=-=-=---=-=--------------------##------------------------------------------------------------------##----------====----------------------#################-##--##--##--#
----------------=-=-=-=-=-=---=-=----------------E--------------------------------------------------------+--------------##---------=====----------E-----------#################-##--##--##--#
===============================================================================---=======================================================-------========-------===============================
