245 16
----------------------------------------------------------------------------------------------------------------------------------------------------------------------------------------------------------------------------------------------------
----------------------------------------------------------------------------------------------------------------------------------------------------------------------------------------------------------------------------------------------------
----------------------------------------------------------------------------------------------------------------------------------------------------------------------------------------------------------------------------------------------------
----------------------------------------------------------------------------------------------------------------------------------------------------------------------------------------------------------------------------------------------------
----------------------------------------------------------------------------------------E-----------------------------------------------------------------------------------------------------------------------------------------------------------
----------------------------------E-------------------------------------------------|=======----------------------------------------------------------------------+-----------------E---------------------------------------------------------------
---------------------------------=====--------------------------------------------|=########---------------------------------------------------------------------===---------------====-------------------------------------------------------------
--------------------------------------------------------------------------------|=##########---------------------------------------------------------------------------------------------------===--------------------------------------------------
-----------------------=====--------------------------------------------------|=############---====---------------------------------=-------------E-------===-----------------==------------------------===-------------------==---------------|==*-
----------------------------------------------------------------------------|=##############-----------------------------------------------------|===-------------------------------------=-------------------------------------------------------x-
-------------=====-----------------------------=====----------------------|=############----------------====--------------------=-------------===####------------------====---------------#-----=-------------------------------------=--------P--x-
-S----------------------------------------------------------------------|=##############-+------------------------------------------------------------------------------------------------#-----#------------------------==------+----------------x-
----------------------------------------------------------------------|=################------------------------------------=-------------------------------------------------------------#-----#--------------------------------=----------------x-
----------------------------------------------------------E---------|=##################====-----------------E-----------------------------------------------------E----------------------#-----#-------E------------=----------------------------x-
====================================================================########################===============================--------------========================================-----====#=====#==================                       ========?=
###########################################################################################################################--------------########################################-----#############################                       ##########
