67 108
---------------------#--------------------------------------------
---------------------#--------------------------------------------
---------------------#--------------------------------------------
---------------------#--------------------------------------------
---------------------#--------------------------------------------
---------------------#--------------------------------------------
---------------------#--------------------+-----------------------
---------------------#--------------------%%----------------------
---------------------#--------------------------------------------
---------------------#--------------------------%%----------------
---------------------#--------------------------------------------
---------------------#--------------------------------------+-----
---------------------#---------------------%%%--------------%%----
---------------------#--------------------------------------------
---------------------#--------------------------------%%%%--------
---------------------#------------------------%%%%%---------------
---------------------#--------------------------------------------
---------------------#-------------------------------------E------
---------------------#-------------------------------------%%%%---
---------------------#--------------------------------------------
---------------------#--------------------------------------------
---------------------#------------------E---------------%%%-------
---------------------#-------------------%%%------%%%%------------
---------------------#--------------------------------------------
---------------------#-------------------------%%-----------------
---------------------#--------------------------------------------
---------------------#--------------------------------------------
---------------------#--------------------%%%---------------------
---------------------#--------------------------------------------
---------------------#--------------------------------------------
---------------------#---------------------+----------------------
---------------------#--------------------%%%%%%--E--E------------
---------------------#------------------------------%%%%%%--------
---------------------#--------------------------------------------
---------------------#---------------------------------------%%---
---------------------#--------------------------------------------
---------------------#---------------------+----------------------
---------------------#---------------------%%--------------%%%----
---------------------#--------------------------------------------
---------------------#-----------------------E--------------------
---------------------#------------------------%%%-----%%%---------
---------------------#--------------------------------------------
---------------------#-----------------------------------%%-------
---------------------#--------------------------------------------
---------------------#----------------------------------------+---
---------------------#---------------------------------------%%---
---------------------#--------------------------------------------
---------------------#-------------------------------------E------
---------------------#-------------------------------------%%%%---
---------------------#--------------------------------------------
---------------------#-----------------------------%%%%%%---------
---------------------#----------------------%%%-------------------
---------------------#--------------------------------------------
---------------------#--------------------------------------------
---------------------#-------------------E------------------------
---------------------#--------------------%%%---------------------
---------------------#--------------------------------------------
---------------------#--------------------------------------------
---------------------#------------------------%%%%-----%%---------
---------------------#-------------------E------------------------
---------------------#--------------------%%%---------------------
---------------------#----------------------------------%%%-------
---------------------#--------------------------------------------
---------------------#--------------------------------------------
---------------------#--------------------+-----------------------
---------------------#--------------------%%-----------------%%---
---------------------#--------------------------------------+-----
---------------------#-------------------------------------%%%----
---------------------#---------------------%%%%---E---------------
---------------------#-----------------------------%%%%-----------
---------------------#--------------------------------------------
---------------------#--------------------------------------------
---------------------#-----------------------------------%%%------
---------------------#-------------------------------------E------
---------------------#-------------------------------E------%%%---
---------------------#--------------------+----------%%%%---------
---------------------#--------------------%%------%%%-------------
---------------------#--------------------------------------------
---------------------#-------------------------%%%----------------
---------------------#--------------------------------------------
---------------------#----------------------%%%%%----------------
---------------------#--------------------------------------------
---------------------#--------------------------------------------
---------------------#-----------------------------------------+--
---------------------#-------------------%%%%----------------%%%--
---------------------#--------------------------------------------
---------------------#-------------------E------%%%%%-------------
---------------------#--------------------%%%%%%-----%%%%%--------
---------------------#--------------------------------------------
---------------------#--------------------------------------------
---------------------#---------------------------------------%%%--
---------------------#--------------------------------------------
---------------------#-------------------------------E-E----------
---------------------#------------------------------%%%%%%%-------
---------------------#--------------------------%%%%--------------
---------------------#------------------------%%------------------
---------------------#--------------------------F----------%%%%%--
---------------------#-----------------E--------------------------
---------------------#-----------------%%%%-----------------------
-------d-------------#--------------------------------------------
---------------------#--------------------------------------------
---------N------------------------------------%%%-----------------
--S---------------------------------------------------------------
------------------------------------------------------------------
------------------------------------------%%%%----E---------------
==================================================================
##################################################################
##################################################################
