53 14
----------------------------------------------------
----------------------------------------------------
----------------------------------------------------
----------------------------------------------------
----------------------------------------------------
----------------------------------------------------
----------------------------------------------------
----------------------------------------------------
---------------------------------------------P------
------------------------N---------------------------
----------------------------------------------------
----------------------------------------------------
----------------------------------------------------
====================================================
