246 34
l-----------------------r#l--------------------------------------------------------------------------------------------------r########################################l------------------------------------------------------------------------------
l-----------------------r#l--------------------------------------------------------------------------------------------------r########################################l------------------------------------------------------------------------------
l-----------------------r#l--------------------------------------------------------------------------------------------------r##################DDDDDDD###############l------------------------------------------------------------------------------
l-----------------------r#l--------------------------------------------------------------------------------------------------r###########DDDDDDD-------DDDDDDDDDDDD###l-------------------------------r#l--------------------------------------------
l-----------------------r#l--------------------------------------------------------------------------------------------------r##lDDDDDDDD--------------------------r##l-------------------------------r#l--------------------------------------------
l-----------------------r#l--------------------------------------------------------------------------------------------------r##l----------------------------------r##l-------------------------------r#l--------------------------------------------
l-----------------------r#l--------------------------------------------------------------------------------------------------r##l----------------------------------r##l-------------------------------r#l--------------------------------------------
l-----------------------r#l--------------------------------------------------------------------------------------------------r##l-----------------------------------r#l-------------------------------r#l--------------------------------------------
l-----------------------r#l--------------------------------------------------------------------------------------------------r##l-----------------------------------r#l-------------------------------r#l--------------------------------------------
l-----------------------r#l--------------------------------------------------------------------------------------------------r##l-----------------------------------r#l-------------------------------r#l--------------------------------------------
l-----------------------r#l--------------------------------------------------------------------------------------------------r##l-----------------------------------r#l-------------------------------r#l--------------------------------------------
l-----------------------r#l--------------------------------------------------------------------------------------------------r##l------------------------------------rl-------------------------------r#l--------------------------------------------
l-----------------------r#l--------------------------------------------------------------------------------------------------r#l-------------------------------------rl-------------------------------r#l--------------------------------------------
l-----------------------r#l--------------------------------------------------------------------------------------------------r#l-------------------------------------rl-------------------------------r#l--------------------------------d-----------
l-----------------------r#l--------------------------------------------------------------------------------------------------rl--------------------------------------rl-------------------------------r#l----------------------------------------P---
l+-------E--------------r#l--------------------------------------------------------------------------------------------------rl-------------------R=L---E------------rl-------------------------------r#l--------------------------------------------
4==============2--------r#l--------------------------------------------------------------------------------------------------rl-------------------r#4======L---------rl-------------------------------r#l--------------------------------------------
DDDDDDDDDD--------------r#l---------------------------------------------------------------------------------------------RL---rl-------------------------------R=L----rl-------------------------------r#l--------------------------------------------
l--------------------1==3#l---------------------------------------------------------------------------------------------rl---rl--------------------------------------rl-------------------------------r#l----------------------------------R=========
l----------------------D##l-------------------------------------------------------------------------------------===-----rl---rl--------------------------------------rl-------------------------------r#l--------------------------------R=3#########
l-----------------------r#l---------------------------------------------------------------------------------------------rl---rl-----------MMM----------------------R=3l-------------------------------r#l-------------------------------R3###########
l---------------+-----------------------------------------------------------------------R======L------------------------rl---rl----MM------------------------------r##l-------------------------------r#l-------------------------------r############
l--------------1=2-----------------------------------------------------------------R====3######l----------------------==rl---rl+-----------------------------------r#Dl-------------------------------r#l-----------------------E--R=L--r############
l----------------------------------------------------------------------------------rDDDDDDDDDDDl------------------------rl---r4==------------------------------R===3l---------------------------------r#l-----------------------R==3#l--r############
l-------------------------------------------E-----------------E------------E------------------------E-------------------rl-+-rDDD-----------------------------------------------------------------E---r#l-+E------------------R=3####l--r############
l-----d---------------------------------R===========LMM------R===LMM------R===L--------------------R===L----------------rl---rl-------------------------R=L---------------------R===---===-------=====3D4=======------------R=3######l--r############
l-------------------===-----------------r###########l--------r###l--------r###l--------------------r###4==L-----=====---rl---rl-------------------------r#l---------------------rD----------------------------------------R=3########l--r############
l-S-------------------------------------r###########l--------r###l--------r###l--------------------rDDDDDDl-------------rl------d-----------------------r#l--------------==L--------------------------------------------R=3##########lWWr############
l----------------------------------R====3###########l--------r###l--------r###l-----------------------------------------rl----------------------R==L----r#l---------------rl----------------------------------------R===3############################
l----------------------------------r################l--------r###l--------r###l-----------------------------------------rl---------------==------r#l----r#l---------------rl----------------------------------------r################################
l----------MMM-------------E-------r################4^^^^^^^^3###4^^^^^^^^3###4^^^^^^^^^^^^^^^^^^^^^^^^^^^^^^^^^^^^^^^^^rl-----------------------r#l----r#l-----E-----E---rl----------------^^RL-------------E------r################################
4=========L-------------R==========3####################################################################################rl=============L---------r#l----r#4===============3l----------------R=34====================3################################
##########lWWWWWWWWWWWWWr##############################################################################################################lWWWWWWWWWr#l^^^^r##################lWWWWWWWWWWWWWWWWr########################################################
##########lWWWWWWWWWWWWWr############################################################################################################################################################################################################################
