214 13
---------------------------------------------------------------------------------------------------------------------------------------------------------------------------------------------------------------------
---------------------------------------------------------------------------------------------------------------------------------------------------------------------------------------------------------------------
-##------------------------------------------------------------------------------------------------------------------------------------------------------------------------------------------==----------------------
---------------------------------------------------------------------------------------------------------------------------------------------------------------------------------------------==----------------------
#-##------------------------###---------------------?????-----------####--------##E##------####-----------------------------####-----------------------------------#####---?-------------#---==----------------------
#-##-----------------------------------------------------------------------------------------------------------------------------------------------------------------------------------------==----------------------
---------------------------------------------------------------------------------------------------------------------------------------------------------------------------------------------==----------------------
-#-###-----------------=---------------------------------------------------------------------------------------------------------------------------------------------------------------------==----------------------
-#-###--------###-----==---------=------------------?????----------#----------????--???---------------PP-----------------------------------------------------------------?--------------##---==-------------###------
######---------------===---------=--------------------------------------------------------------------PP-------------------------------------------------=---------------------##------------==----------------------
#-#-##--------------====---------==----------##--------------------------##---------------------------PP-------------------------##----------------------=---------------------##------------==------------##-##-----
#-#-##-------------=====----E----==----------##--------------------E----------------------------------PP------------+--------######--------------E-------=---------------------##------------==--------=---##-##-----
===========================================================================================----==========---==============================---==========--===========================================================-
