191 13
----------------------------------------------------------------------------------------------------------------------------------------------------------------------------------------------
-----###################################################################################E################################################-----------------------#######PP#################---#
-----------------------------------------------------##--######--####------####----------------------------------------------------------------------------------------PP#######-------------#
-----------------------------------------------------##--######--####------####----------------------------------------------------------------------------------------PP#######-------------#
---------------------------------------------------##--------##---#----##----------------------------------------------------------------------------------------------PP#######-------------#
---------------------------------------------------##--------##---#----#-----------------------------------------------------------------------------------------------PP#######-------------#
--------------------------------------#-####-E-----##--------##---#----#-----------######------------------------------------------------------------------------------PP#######-------------#
----------------------------E---------#-#--#-#-----##--------##---#-E--#E----------######-------------------------------------------------------#####E-----------------PP#######-------------#
---------=====--------=-=-------------###--###-----####--######---###--##--####-----------------------------PP-------------------------==------------------------------PP#######-------------#
--------------------=-=-=-=---=----------------------##-----------------------------------------------PP----PP-----------##-----------===----------------------#################-PP--PP--PP--#
------------------=-=-=-=-=---=-=--------------------##-----------------------------------------------PP----PP----PP-----##----------====----------------------#################-PP--PP--PP--#
----------------=-=-=-=-=-=---=-=---------------------------------------------------------------------PP----PP----PP-----##---------=====----------------------#################-PP--PP--PP--#
===============================================================================---=====================================--==--============-------========-------===============================