---###-------------------------###----##---------------------------------
-------------------------------------------------------------------------
-------------------------------------------------------------------------
-------------------------------------------------------------------------
-------------------------------------------------------------------------
---###-------------------------###----##---------------------------------
-------------------------------------------------------------------------
-------------------------------------------------------------------------
-------------------------------------------------------------------------
---#-----#E-------------#----------##------=--=----------==--=-----------
-------------------------------------------------==--==--------===--==---
--------===-------------------------------------===--===------====--=====
------=====-----------------------------------------====--====----=====--
=========================================================================