211 13
------------------------------------------------------------------------------------------------------------------------------------------------------------------------------------------------------------------
------------------------------------------------------------------------------------------------------------------------------------------------------------------------------------------------------------------
------------------------------------------------------------------------------------------------------------------------------------------------------------------------------------------------------------------
------------------------------------------------------------------------------------------------------------------------------------------------------------------------------------------------------------------
---------------------?----------------------------------------------------------########---###?--------------?-----------###----#??#--------------------------------------------------------==--------------------
------------------------------------------------------------------------------------------------------------------------------------------------------------------------------------------===---------------------
--------------------------------------------------------------------------------------------------------------------------------------------------+----------------------------------------====--------------F----
----------------------------------------------------------------------------------------------------------------------------------------------------------------------------------------E====-------------CCC-----
---------------?---#?#?#--------------------------------PP------------------#?#--------------#-----#-----?--?--?-----#----------##------=--=----------==--=------------##?#------------======-------------C##-----
---------------------------------------------------------------------------------------------------------------------------------------==--==--------===--==--------------------------=======------------CCCCC----
--------------------------------------------------------------------------------------------------------------------------------------===--===------====--===-----PP--------------PP-========------------##-##----
----------------------------E---------------------------PP-------------+-------------------------------E-----------------------------====--====----=====--====----PP--------------PP=========--------=---##-##----
====================================================================--===============---================================================================--========================================================
