224 13
-------------------------------------------------------------------------------------------------------------------------------------------------------------------------------------------------------------------------------
-------------------------------------------------------------------------------------------------------------------------------------------------------------------------------------------------------------------------------
-------------------------------------------------------------------------------------------------------------------------------------------------------------------------------------------------------------------------------
-------------------------------------------------------------------------------------------------------------------------------------------------------------------------------------------------------------------------------
-----------------------------------------------------------########-----------------------------------------------########---------------------------------------------------------------------------------==----------------##
--------------------------------------------------------------------------------------------------------------------------------------------------------------------------------------------+--------------------------------##
-----------------------------------------------------------------------------------------------------+-----------------------------##################################------####################----------=---------------------
-----------------------########-----##############----------------------------######---######---##########-------------------------##################################------##################-#----------------------------###-
-##--------------------########-----##############---------########---=-------######---######---##########--==----########---------##################################------####################--------=-------------------###-
-----------------------########-----##############--------------------==------######---######-=-##########--==---------------------##################################--##--####################----------------------------####
#-##-------------------####-###-----##############--------------------===-----######---###-##-=-##########--==---------------------#############-####################--##--####################---=--=---------------------##-#
#-##-------------------########-----##############--------E-----------====----######---######-=-##########--==---------------------####-#############################--##--#####-#######-######---=----------------E-=-----##-#
====================================================================--====--========================================================================================================================-----------================
