211 13
------------------------------------------------------------------------------------------------------------------------------------------------------------------------------------------------------------------
------------------------------------------------------------------------------------------------------------------------------------------------------------------------------------------------------------------
------------------------------------------------------------------------------------------------------------------------------------------------------------------------------------------------------------------
------------------------------------------------------------------------------------------------------------------------------------------------------------------------------------------------------------------
---------------------?----------------------------------------------------------########---###?--------------?-----------###----#??#--------------------------------------------------------==--------------------
------------------------------------------------------------------------------------------------------------------------------------------------------------------------------------------===---------------------
--------------------------------------------------------------------------------------------------------------------------------------------------+----------------------------------------====-------------------
----------------------------------------------------------------------------------------------------------------------------------------------------------------------------------------E====-------------###-----
---------------?---#?#?#--------------------------------PP------------------#?#--------------#-----#-----?--?--?-----#----------##------=--=----------==--=------------##?#------------======-------------?##-----
---------------------------------------------------------------------------------------------------------------------------------------==--==--------===--==--------------------------=======------------#####----
--------------------------------------------------------------------------------------------------------------------------------------===--===------====--===-----##--------------##-========------------##-##----
----------------------------E---------------------------PP-------------+-------------------------------E-----------------------------====--====----=====--====----##--------------##=========--------=---##-##----
====================================================================--===============---================================================================--========================================================
