51 14
--------------------------------------------------
--------------------------------------------------
--------------------------------------------------
--------------------------------------------------
--------------------------------------------------
--------------------------------------------------
--------------------------------------------------
--------------------------------------------------
---------------------------------------------P----
------------------------N-------------------------
--------------------------------------------------
--------------------------------------------------
--------------------------------------------------
==================================================
