-------------------------------------------------------------------------
-------------------------------------------------------------------------
-------------------------------------------------------------------------
-------------------------------------------------------------------------
---###-------------------------###----##---------------------------------
-------------------------------------------------------------------------
-------------------------------------------------------------------------
-------------------------------------------------------------------------
---#-----#E-------------#----------##------=--=----------==--=-----------
-------------------------------------------------==--==--------===--==---
------------------------------------------------===--===------====--===--
-----------------------------------------------====--====----=====--====-
================================================================--=======