214 13
---------------------------------------------------------------------------------------------------------------------------------------------------------------------------------------------------------------------
CCC------------------------------------------------------------------------------------------------------------------------------------------------------------------------------------------------------------------
C##------------------------------------------------------------------------------------------------------------------------------------------------------------------------------------------==----------------------
CCCC-----------------------------------------------------------------------------------------------------------------------------------------------------------------------------------------==----------------------
#-##-----------------------E###---------------------?????-----------E###--------##E##------####-----------------------------E###-----------------------------------#####---E-------------E---==----------------------
#-##-----------------------------------------------------------------------------------------------------------------------------------------------------------------------------------------==----------------------
CCCCCC---------------------------------------------------------------------------------------------------------------------------------------------------------------------------------------==----------------------
-#-###-----------------=---------------------------------------------------------------------------------------------------------PP----------------------------------------------------------==-------------CCC------
-#-###--------#E#-----==---E-----=-----------PP-----?????----------#-----PP---????--???---------------PP-----------------PP------PP-----------------------------E--------?--------------##---==-------------C##------
######---------------===---------=-----------PP--------------------------PP---------------------------PP-----------------PP--PP--PP----------------------=---------------------PP------------==------------CCCCC-----
#-#-##--------------====---------==----------PP--------------------------PP---------------------------PP----------PP-----PP--PP--PP----------------------=---------------------PP------------==------------##-##-----
#-#-##-------------=====---------==----------PP--------------------------PP---------------------------PP----------PP-----PP--PP--PP----------------------=---------------------PP------------==--------=---##-##-----
===========================================================================================----==========---==============================---==========--===========================================================-