211 13
------------------------------------------------------------------------------------------------------------------------------------------------------------------------------------------------------------------
------------------------------------------------------------------------------------------------------------------------------------------------------------------------------------------------------------------
------------------------------------------------------------------------------------------------------------------------------------------------------------------------------------------------------------------
------------------------------------------------------------------------------------------------------------------------------------------------------------------------------------------------------------------
---------------------?---------------EEE-------------------EEEE-----------------########---###?--------------?-----------###----#??#--------------------------------------------------------==--------------------
--------------------------------------------------EE--------------------------------------------------------------------------------------------------------------------------------------===---------------------
-----------------------------EEEEE-----------EE---------------------------------------------------------------------------------------------------+----------------------------------------====--------------F----
---------------------------------------------------------------E------------------------------------------------------------------------------------------------------------------------=====-------------CCC-----
---------------?---#?#?#--------------------------------PP------------------#?#--------------#-----#E----?--?--?-----#----------##------=--=----------==--=------------##?#------------======-------------C##-----
-------------------------------------EE------EE----------------------------------------------------------------------------------------==--==--------===--==--------------------------=======------------CCCCC----
---------------------------EE---------------------------------------------------------------------------------------------------------===--===------====--===-----PP--------------PP-========------------##-##----
--------------------------------------------------------PP-------------+-------------------------------------------------------------====--====----=====--====----PP--------------PP=========--------=---##-##----
====================================================================--===============---================================================================--========================================================
